{
  "meta": { "name": "Level 3 • Platforms, Bots & Boosts", 
  "timeLimit": 95 },
  "background": "./assets/backgrounds/level-01.png",
  "tileset": {
  "image": "./assets/tiles/tileset.png",
  "meta": "./assets/tiles/tileset.json"
},
  "tileSize": 32,
  "w": 72,
  "h": 18,
  "tiles": [
    1,0,0,0,0,0,0,0,0,0,0,0,0,0,0,0,0,0,0,0,0,0,0,0,0,0,0,0,0,0,0,0,0,0,0,0,0,0,0,0,0,0,0,0,0,0,0,0,0,0,0,0,0,0,0,0,0,0,0,0,0,0,0,0,0,0,0,0,0,0,0,1,
    1,0,0,0,0,0,0,0,0,0,0,0,0,0,0,0,0,0,0,0,0,0,0,0,0,0,0,0,0,0,0,0,0,0,0,0,0,0,0,0,0,0,0,0,0,0,0,0,0,0,0,0,0,0,0,0,0,0,0,0,0,0,0,0,0,0,0,0,0,0,0,1,
    1,0,0,0,0,0,0,0,0,0,0,0,0,0,0,0,0,0,0,0,0,0,0,0,0,0,0,0,0,0,0,0,0,0,0,0,0,0,0,0,0,0,0,0,0,0,0,0,0,0,0,0,0,0,0,0,0,0,0,0,0,0,0,0,0,0,0,0,0,0,0,1,
    1,0,0,0,0,0,0,0,0,0,0,0,0,0,0,0,0,0,0,0,0,0,0,0,0,0,0,0,0,0,0,0,0,0,0,0,0,0,0,0,0,0,0,0,0,0,0,0,0,0,0,0,0,0,0,0,0,0,0,0,0,0,0,0,0,0,0,0,0,0,0,1,
    1,0,0,0,0,0,0,0,0,0,0,0,0,0,0,0,0,0,0,0,0,0,0,0,0,0,0,0,0,0,0,0,0,0,0,0,0,0,0,0,0,0,0,0,0,0,0,0,0,0,0,0,0,0,0,0,0,0,0,0,0,0,0,0,0,0,0,0,0,0,0,1,
    1,0,0,0,0,0,0,0,0,0,0,0,0,0,0,0,0,0,0,0,0,0,0,0,0,0,0,0,0,0,0,0,0,0,0,0,0,0,0,0,0,0,0,0,0,0,0,0,0,0,0,0,0,0,0,0,0,0,0,0,0,0,0,0,0,0,0,0,0,0,0,1,
    1,0,0,0,0,0,0,0,0,0,0,0,0,0,0,0,0,0,0,0,0,0,0,0,0,0,0,0,0,0,0,0,0,0,0,0,0,0,0,0,0,0,0,0,0,0,0,0,0,0,0,0,0,0,0,0,0,0,0,0,0,0,0,0,0,0,0,0,0,0,0,1,
    1,0,0,0,0,0,0,0,0,0,0,0,0,0,0,0,0,0,0,0,0,0,0,0,0,0,0,0,0,0,0,0,0,0,0,0,0,0,0,0,0,0,0,0,0,0,0,0,0,0,0,0,0,0,0,0,0,0,0,0,0,0,0,0,0,0,0,0,0,0,0,1,
    1,0,0,0,0,0,0,0,0,0,0,0,0,0,0,0,0,0,0,0,0,0,0,0,0,0,0,0,0,0,0,0,0,0,0,0,0,0,0,0,0,0,0,0,0,0,0,0,0,0,0,0,0,0,0,0,0,0,0,0,0,0,0,0,0,0,0,0,0,0,0,1,
    1,0,0,0,0,0,0,0,0,0,0,0,0,0,0,0,0,0,0,0,0,0,0,0,0,0,0,0,0,0,0,0,0,0,0,0,0,0,0,0,0,0,0,0,0,0,0,0,0,0,0,0,0,0,0,0,0,0,0,0,0,0,0,0,0,0,0,0,0,0,0,1,

    1,0,0,0,0,0,0,0,0,0,0,0,0,0,0,0,0,0,0,0,0,0,0,0,0,0,0,0,0,0,0,0,0,0,0,0,0,0,0,0,0,0,0,0,0,0,0,0,0,0,0,0,0,0,0,0,0,0,0,0,0,0,0,0,0,0,0,0,0,0,0,1,

    1,0,0,0,0,0,0,0,0,0,0,0,0,0,0,0,0,0,0,0,0,0,0,0,0,0,0,0,0,0,0,0,0,0,0,0,0,0,0,0,0,0,0,0,0,0,0,0,0,0,0,0,0,0,0,0,0,0,0,0,0,0,0,0,0,0,0,0,0,0,0,1,

    1,0,0,0,0,0,0,0,0,0,0,0,0,0,0,0,0,0,0,0,0,0,0,0,0,0,0,0,0,0,0,0,0,0,0,0,0,0,0,0,0,0,0,0,0,0,0,0,0,0,0,0,0,0,0,0,0,0,0,0,0,0,0,0,0,0,0,0,0,0,0,1,

    1,1,1,1,1,1,1,1,1,0,0,0,0,0,0,0,0,0,0,0,1,1,1,1,1,0,0,0,0,0,0,0,0,0,0,0,1,1,1,1,1,0,0,0,0,0,0,0,0,0,0,0,1,1,1,1,1,0,0,0,0,0,0,0,0,1,1,1,1,1,1,1,
    1,1,1,1,1,1,1,1,1,0,0,0,0,0,0,0,0,0,0,0,1,1,1,1,1,0,0,0,0,0,0,0,0,0,0,0,1,1,1,1,1,0,0,0,0,0,0,0,0,0,0,0,1,1,1,1,1,0,0,0,0,0,0,0,0,1,1,1,1,1,1,1,
    1,1,1,1,1,1,1,1,1,1,1,1,1,1,1,1,1,1,1,1,1,1,1,1,1,1,1,1,1,1,1,1,1,1,1,1,1,1,1,1,1,1,1,1,1,1,1,1,1,1,1,1,1,1,1,1,1,1,1,1,1,1,1,1,1,1,1,1,1,1,1,1
  ],

  "spawn": { "x": 3, "y": 13 },
  "exit": { "x": 67, "y": 13 },

  "coins": [
    { "x": 6, "y": 12 }, { "x": 7, "y": 12 }, { "x": 8, "y": 12 },
    { "x": 13, "y": 10 }, { "x": 14, "y": 10 }, { "x": 15, "y": 10 },

    { "x": 24, "y": 9 }, { "x": 25, "y": 9 }, { "x": 26, "y": 9 },

    { "x": 36, "y": 12 }, { "x": 37, "y": 12 }, { "x": 38, "y": 12 },

    { "x": 49, "y": 10 }, { "x": 50, "y": 10 }, { "x": 51, "y": 10 },

    { "x": 62, "y": 12 }, { "x": 63, "y": 12 }, { "x": 64, "y": 12 }
  ],

  "hazards": [
    { "x": 10, "y": 15, "w": 4, "h": 1, "type": "spikes" },
    { "x": 28, "y": 15, "w": 5, "h": 1, "type": "spikes" },
    { "x": 44, "y": 15, "w": 4, "h": 1, "type": "spikes" },
    { "x": 57, "y": 15, "w": 3, "h": 1, "type": "spikes" }
  ],

  "platforms": [
    {
      "x": 12,
      "y": 12,
      "w": 3,
      "h": 0.5,
      "path": [{ "x": 12, "y": 12 }, { "x": 18, "y": 12 }],
      "speed": 2.4
    },
    {
      "x": 22,
      "y": 10,
      "w": 3,
      "h": 0.5,
      "path": [{ "x": 22, "y": 10 }, { "x": 29, "y": 8 }],
      "speed": 2.0
    },
    {
      "x": 41,
      "y": 12,
      "w": 3,
      "h": 0.5,
      "path": [{ "x": 41, "y": 12 }, { "x": 46, "y": 10 }],
      "speed": 2.2
    },
    {
      "x": 53,
      "y": 11,
      "w": 3,
      "h": 0.5,
      "path": [{ "x": 53, "y": 11 }, { "x": 60, "y": 11 }],
      "speed": 2.6
    }
  ],

  "enemies": [
    { "x": 20, "y": 13, "w": 0.9, "h": 0.9, "minX": 19, "maxX": 25, "speed": 2.3 },
    { "x": 46, "y": 13, "w": 0.9, "h": 0.9, "minX": 44, "maxX": 50, "speed": 2.6 }
  ],

  "powerups": [
    { "x": 8, "y": 12, "type": "dash", "duration": 9 },
    { "x": 40, "y": 11, "type": "doublejump", "duration": 12 }
  ]
}
